5 10
|--------|
|.@.|....|
|...|....|
|......|.>
|--------|