10 10
|--------|
|.@..|...|
|.-....|.|
|..|.....|
|..|.....|
|..|--...|
|.....|..|
|.......-|
|........>
|--------|